..........
..........
..........
..........
..........
..........
..........
..........
1.........
..........
..........
..........
..........
..........
..........
..........
..........
..........
..........
..........
..........
111111....
2222222...
33333333..
444444444.
..........
..........
..........
..........
..........
