.........
.........
.3333333.
.3333333.
.2222222.
.2222222.
.1111111.
.1111111.
.........
.........
