..........
..........
..........
..........
..........
..........
..........
14........
..........
..........
..........
..........
..........
..........
..........
..........
..........
..........
..........
..........
..........
111111....
2.22222...
33333333..
444444444.
..........
..........
..........
..........
..........
